urlHelp=Scripts/mxGraph/src/editor/help/index.html
lastSaved=Guardar por última vez
currentFile=Archivo actual
toolbar=Herramientas
save=Guardar
print=Imprimir
cut=Cortar
copy=Copiar
paste=Pegar
delete=Borrar
undo=Deshacer
redo=Rehacer
select=Selección
connect=Conexión
message=Información
pan=Pan
zoomIn=Ampliación
zoomOut=Encoger
zoom=Zoom
fit=Apto para
actualSize=Tamaño real
selectAll=Selección completa
clearSelection=Borrar selección
shape=Forma
format=Formato
font=Tipo de letra
group=Grupo
ungroup=Desarticulación
removeFromParent=Huérfano
align=Permutación
left=Izquierda
right=Wright
center=Centro
top=Top
middle=Medio
bottom=Bottom
collapse=Colapso
expand=Desenrollar
toBack=Enviar a la parte posterior
toFront=Ponlo delante.
enterGroup=Grupo de entrada
exitGroup=Grupo de salida
layout=Diseño
horizontalTree= árbol horizontal
verticalTree=Erección
fillColor=Color de relleno
strokeColor=Color de línea
gradientColor=Gradiente
bold=Negrita
italic=Cursiva
fontColor=Color de la fuente
fontSize=Tamaño de la fuente
fontFamily=Serie de tipos de letra
processList=Lista de procesos
newDiagram=Nuevo gráfico
openDiagram=Abrir gráfico
saveDiagram=Guardar gráfico
previewXml=Previsualización XML
importDiagram=Importar diagrama
image=Imagen
opacity=Opacidad
selection=Selección
editStyle=Editar estilo
enterStyle=Estilo de entrada
enterColorname=Introduzca un nombre de color
enterImageUrl=Introduzca la URL de la imagen
enterOpacity=Opacidad de entrada (%)
enterFontsize=Introduzca el tamaño de la fuente (pt)
enterFontfamily=Introduzca la familia de fuentes
toggleRounded=Redondeo
toggleShadow=Sombra
openHref=Abrir página
show=Mostrar
exportImage=Exportar imagen
exportSvg=Exportar SVG
changesLost=Todos los cambios se perderán!
swimlanes=Pista de baño
travelBooking=Reserva de viajes
notAvailable=No disponible

